1 1 1 1 1 1 1 1 2 1 1 1 1 1 1 1 1
1 4 2 2 2 2 3 1 2 1 2 2 2 2 2 2 1
1 2 1 1 1 1 2 1 2 1 2 1 1 1 1 2 1
1 2 1 0 0 1 2 1 2 1 2 1 0 0 1 2 1
1 2 1 0 0 1 2 1 2 1 2 1 0 0 1 2 1
1 2 1 1 1 1 2 1 2 1 2 1 1 1 1 2 1
1 2 2 2 2 2 2 1 2 1 2 2 2 2 2 2 1
1 2 1 1 1 1 2 1 2 1 2 1 1 1 1 2 1
1 2 2 2 2 2 2 2 2 2 2 2 2 2 2 2 1
1 2 1 1 1 1 1 1 1 1 1 1 1 1 1 2 1
1 2 2 2 2 2 2 2 2 2 2 2 2 2 2 2 1
1 1 1 1 1 2 1 1 5 1 1 2 1 1 1 1 1
2 2 2 2 2 2 1 0 0 0 1 2 2 2 2 2 2
1 1 1 1 1 2 1 1 1 1 1 2 1 1 1 1 1
1 2 2 2 2 2 2 2 2 2 2 2 2 2 2 2 1
1 2 1 1 1 1 1 1 1 1 1 1 1 1 1 2 1
1 2 2 2 2 2 2 2 2 2 2 2 2 2 2 2 1
1 2 1 1 1 1 2 1 2 1 2 1 1 1 1 2 1
1 2 2 2 2 2 2 1 2 1 2 2 2 2 2 2 1
1 2 1 1 1 1 2 1 2 1 2 1 1 1 1 2 1
1 2 1 0 0 1 2 1 2 1 2 1 0 0 1 2 1
1 2 1 0 0 1 2 1 2 1 2 1 0 0 1 2 1
1 2 1 1 1 1 2 1 2 1 2 1 1 1 1 2 1
1 2 2 2 2 2 2 1 2 1 2 2 2 2 2 2 1
1 1 1 1 1 1 1 1 2 1 1 1 1 1 1 1 1

1 1 1 1 1 1 1 1 2 1 1 1 1 1 1 1 1
1 4 2 2 2 2 2 1 2 1 2 2 2 2 2 2 1
1 2 1 1 1 1 2 1 2 1 2 1 1 1 1 2 1
1 2 1 0 0 1 2 1 2 1 2 1 0 0 1 2 1
1 2 1 0 0 1 2 1 2 1 2 1 0 0 1 2 1
1 2 1 1 1 1 2 1 2 1 2 1 1 1 1 2 1
1 2 2 2 2 2 2 1 2 1 2 2 2 2 2 2 1
1 2 1 1 1 1 2 1 2 1 2 1 1 1 1 2 1
1 2 2 2 2 2 2 2 2 2 2 2 2 2 2 2 1
1 2 1 1 1 1 1 1 1 1 1 1 1 1 1 2 1
1 2 2 2 2 2 2 2 2 2 2 2 2 2 2 2 1
1 1 1 1 1 2 1 1 5 1 1 2 1 1 1 1 1
2 2 2 2 2 2 1 0 0 0 1 2 2 2 2 2 2
1 1 1 1 1 2 1 1 1 1 1 2 1 1 1 1 1
1 2 2 2 2 2 2 2 2 2 2 2 2 2 2 2 1
1 2 1 1 1 1 1 1 1 1 1 1 1 1 1 2 1
1 2 2 2 2 2 2 2 2 2 2 2 2 2 2 2 1
1 2 1 1 1 1 2 1 2 1 2 1 1 1 1 2 1
1 2 2 2 2 2 2 1 2 1 2 2 2 2 2 2 1
1 2 1 1 1 1 2 1 2 1 2 1 1 1 1 2 1
1 2 1 0 0 1 2 1 2 1 2 1 0 0 1 2 1
1 2 1 0 0 1 2 1 2 1 2 1 0 0 1 2 1
1 2 1 1 1 1 2 1 2 1 2 1 1 1 1 2 1
1 2 2 2 2 2 2 1 2 1 2 2 2 2 2 2 1
1 1 1 1 1 1 1 1 2 1 1 1 1 1 1 1 1
